a      | aa a
ai     | aa ai
an     | aa an
ang    | aa ang
ao     | aa ao
ba     | b  a
bai    | b  ai
ban    | b  an
bang   | b  ang
bao    | b  ao
bei    | b  ei
ben    | b  en
beng   | b  eng
bi     | b  i
bia    | b  ia
bian   | b  ian
biang  | b  iang
biao   | b  iao
bie    | b  ie
bin    | b  in
bing   | b  ing
biu    | b  iou
bo     | b  o
bong   | b  ong
bou    | b  ou
bu     | b  u
ca     | c  a
cai    | c  ai
can    | c  an
cang   | c  ang
cao    | c  ao
ce     | c  e
cei    | c  ei
cen    | c  en
ceng   | c  eng
ci     | c  iy
cong   | c  ong
cou    | c  ou
cu     | c  u
cua    | c  ua
cuai   | c  uai
cuan   | c  uan
cuang  | c  uang
cui    | c  uei
cun    | c  uen
cuo    | c  uo
cha    | ch a
chai   | ch ai
chan   | ch an
chang  | ch ang
chao   | ch ao
che    | ch e
chei   | ch ei
chen   | ch en
cheng  | ch eng
chi    | ch ix
chong  | ch ong
chou   | ch ou
chu    | ch u
chua   | ch ua
chuai  | ch uai
chuan  | ch uan
chuang | ch uang
chui   | ch uei
chun   | ch uen
chuo   | ch uo
da     | d  a
dai    | d  ai
dan    | d  an
dang   | d  ang
dao    | d  ao
de     | d  e
dei    | d  ei
den    | d  en
deng   | d  eng
der    | d  er
di     | d  i
dia    | d  ia
dian   | d  ian
diang  | d  iang
diao   | d  iao
die    | d  ie
din    | d  in
ding   | d  ing
diong  | d  iong
diu    | d  iou
dong   | d  ong
dou    | d  ou
du     | d  u
dua    | d  ua
duai   | d  uai
duan   | d  uan
duang  | d  uang
dui    | d  uei
dun    | d  uen
duo    | d  uo
e      | ee e
ei     | ee ei
en     | ee en
eng    | ee eng
er     | ee er
fa     | f  a
fai    | f  ai
fan    | f  an
fang   | f  ang
fao    | f  ao
fei    | f  ei
fen    | f  en
feng   | f  eng
fer    | f  er
fo     | f  o
fou    | f  ou
fu     | f  u
ga     | g  a
gai    | g  ai
gan    | g  an
gang   | g  ang
gao    | g  ao
ge     | g  e
gei    | g  ei
gen    | g  en
geng   | g  eng
ger    | g  er
gong   | g  ong
gou    | g  ou
gu     | g  u
gua    | g  ua
guai   | g  uai
guan   | g  uan
guang  | g  uang
gui    | g  uei
gun    | g  uen
guo    | g  uo
ha     | h  a
hai    | h  ai
han    | h  an
hang   | h  ang
hao    | h  ao
he     | h  e
hei    | h  ei
hen    | h  en
heng   | h  eng
her    | h  er
hia    | h  ia
hong   | h  ong
hou    | h  ou
hu     | h  u
hua    | h  ua
huai   | h  uai
huan   | h  uan 
huang  | h  uang
hui    | h  uei
hun    | h  uen
huo    | h  uo
i      | ii i
ji     | j  i
jia    | j  ia
jian   | j  ian
jiang  | j  iang
jiao   | j  iao
jie    | j  ie
jin    | j  in
jing   | j  ing
jiong  | j  iong
jiu    | j  iou
jv     | j  v
ju     | j  v
jvan   | j  van
juan   | j  van
jve    | j  ve
jue    | j  ve
jvn    | j  vn
jun    | j  vn
ka     | k  a
kai    | k  ai
kan    | k  an
kang   | k  ang
kao    | k  ao
ke     | k  e
kei    | k  ei
ken    | k  en
keng   | k  eng
ker    | k  er
kong   | k  ong
kou    | k  ou
ku     | k  u
kua    | k  ua
kuai   | k  uai
kuan   | k  uan
kuang  | k  uang
kui    | k  uei
kun    | k  uen
kuo    | k  uo
la     | l  a
lai    | l  ai
lan    | l  an
lang   | l  ang
lao    | l  ao
le     | l  e
lei    | l  ei
len    | l  en
leng   | l  eng
ler    | l  er
li     | l  i
lia    | l  ia
lian   | l  ian
liang  | l  iang
liao   | l  iao
lie    | l  ie
lin    | l  in
ling   | l  ing
liu    | l  iou
long   | l  ong
lou    | l  ou
lu     | l  u
luan   | l  uan
lun    | l  uen
luo    | l  uo
lv     | l  v
lve    | l  ve
ma     | m  a
mai    | m  ai
man    | m  an
mang   | m  ang
mao    | m  ao
me     | m  e
mei    | m  ei
men    | m  en
meng   | m  eng
mer    | m  er
mi     | m  i
mia    | m  ia
mian   | m  ian
miang  | m  iang
miao   | m  iao
mie    | m  ie
min    | m  in
ming   | m  ing
miu    | m  iou
mo     | m  o
mou    | m  ou
mu     | m  u
na     | n  a
nai    | n  ai
nan    | n  an
nang   | n  ang
nao    | n  ao
ne     | n  e
nei    | n  ei
nen    | n  en
neng   | n  eng
ner    | n  er
ni     | n  i
nian   | n  ian
niang  | n  iang
niao   | n  iao
nie    | n  ie
nin    | n  in
ning   | n  ing
niu    | n  iou
nong   | n  ong
nou    | n  ou
nu     | n  u
nua    | n  ua
nuai   | n  uai
nuan   | n  uan
nuo    | n  uo
nv     | n  v
nve    | n  ve
ou     | oo ou
pa     | p  a
pai    | p  ai
pan    | p  an
pang   | p  ang
pao    | p  ao
pei    | p  ei
pen    | p  en
peng   | p  eng
per    | p  er
pi     | p  i
pia    | p  ia
pian   | p  ian
piang  | p  iang
piao   | p  iao
pie    | p  ie
pin    | p  in
ping   | p  ing
piu    | p  iou
po     | p  o
pong   | p  ong
pou    | p  ou
pu     | p  u
qi     | q  i
qia    | q  ia
qian   | q  ian
qiang  | q  iang
qiao   | q  iao
qie    | q  ie
qin    | q  in
qing   | q  ing
qiong  | q  iong
qiu    | q  iou
qu     | q  v
qv     | q  v
quan   | q  van
qvan   | q  van
que    | q  ve
qve    | q  ve
qun    | q  vn
qvn    | q  vn
ran    | r  an
rang   | r  ang
rao    | r  ao
re     | r  e
ren    | r  en
reng   | r  eng
ri     | r  ix
rong   | r  ong
rou    | r  ou
ru     | r  u
ruan   | r  uan
rui    | r  uei
run    | r  uen
ruo    | r  uo
sa     | s  a
sai    | s  ai
san    | s  an
sang   | s  ang
sao    | s  ao
se     | s  e
sei    | s  ei
sen    | s  en
seng   | s  eng
ser    | s  er
si     | s  iy
song   | s  ong
sou    | s  ou
su     | s  u
sua    | s  ua
suai   | s  uai
suan   | s  uan
suang  | s  uang
sui    | s  uei
sun    | s  uen
suo    | s  uo
sha    | sh a
shai   | sh ai
shan   | sh an
shang  | sh ang
shao   | sh ao
she    | sh e
shei   | sh ei
shen   | sh en
sheng  | sh eng
shi    | sh ix
shou   | sh ou
shu    | sh u
shua   | sh ua
shuai  | sh uai
shuan  | sh uan
shuang | sh uang
shui   | sh uei
shun   | sh uen
shuo   | sh uo
ta     | t  a
tai    | t  ai
tan    | t  an
tang   | t  ang
tao    | t  ao
te     | t  e
tei    | t  ei
teng   | t  eng
ter    | t  er
ti     | t  i
tian   | t  ian
tiao   | t  iao
tie    | t  ie
ting   | t  ing
tiu    | t  iou
tong   | t  ong
tou    | t  ou
tu     | t  u
tua    | t  ua
tuai   | t  uai
tuan   | t  uan
tui    | t  uei
tun    | t  uen
tuo    | t  uo
wa     | uu ua
wai    | uu uai
wan    | uu uan
wang   | uu uang
wei    | uu uei
wen    | uu uen
weng   | uu ueng
wo     | uu uo
wu     | uu u
ya     | ii ia
yan    | ii ian
yang   | ii iang
yao    | ii iao
ye     | ii ie
yi     | ii i
yin    | ii in
ying   | ii ing
yong   | ii iong
you    | ii iou
yu     | vv v
yv     | vv v
yuan   | vv van
yvan   | vv van
yue    | vv ve
yve    | vv ve
yun    | vv vn
yvn    | vv vn
xi     | x  i
xia    | x  ia
xian   | x  ian
xiang  | x  iang
xiao   | x  iao
xie    | x  ie
xin    | x  in
xing   | x  ing
xiong  | x  iong
xiu    | x  iou
xu     | x  u
xv     | x  v
xuan   | x  van
xvan   | x  van
xue    | x  ve
xve    | x  ve
xun    | x  vn
xvn    | x  vn 
za     | z  a
zai    | z  ai
zan    | z  an
zang   | z  ang
zao    | z  ao
ze     | z  e
zei    | z  ei
zen    | z  en
zeng   | z  eng
zer    | z  er
zi     | z  iy
zong   | z  ong
zou    | z  ou
zu     | z  u
zua    | z  ua
zuai   | z  uai
zuan   | z  uan
zuang  | z  uang
zui    | z  uei
zun    | z  uen
zuo    | z  uo
zha    | zh a
zhai   | zh ai
zhan   | zh an
zhang  | zh ang
zhao   | zh ao
zhe    | zh e
zhen   | zh en
zheng  | zh eng
zher   | zh er
zhi    | zh ix
zhong  | zh ong
zhou   | zh ou
zhu    | zh u
zhua   | zh ua
zhuai  | zh uai
zhuan  | zh uan
zhuang | zh uang
zhui   | zh uei
zhun   | zh uen
zhuo   | zh uo